ola mundo = hello world
batata = potato
bebida = drink
ele = he
ela = she
cachorro = dog
cidade = city
agua = water
fogo = fire
casa = house
azul = blue
vermelho = red
verde = green
marrom = brown
preto = black
rosa = pink
amarelo = yellow
branco = white
cinza = gray
dourado = gold
prata = silver
violeta = purple
laranja = orange
gato = cat
lapis = pencil
guarda chuva = umbrella
chuva = rain
aquele = that
aqueles = those
este = this
estes = these